    R 1000 1000
 

C 225,   30, 0   

 F 220, 100, 2     

  
        1111  1111111111111111111111
        1001  1110000110000000000001
        1011 11001110000002000001111
        1001110000000000000000001
111111111011000001110000000000001
110000000011000001110111111111111
11110111111111011100000010001
11110111111111011101010010001
1111000011010101110000001000111111
    10000200000000000110000001001   
   111100011100000011010100100011
11110001110101011111011110N01111
10000001 1000101   10111010000111
11111111 1111111  11111111111111  