    R 2000 1000

   

 C 252, 0, 0

 F 100, 100, 110    
 

                        NO ./textures/grey.xpm
                            SO ./textures/brick.xpm


WE ./textures/blue.xpm
EA ./textures/wood.xpm
S ./textures/eye.xpm 


        1111  1111111111111111111111  
        11001  1110000110000000000001
        11011 11001110000000000001111
        1001110000000000000000001
111111111011000001110000000000001
110000000011000001110111111111111
11110111111111011100000010001
111101111111110111010100100011111111111
111100001101010111000000100000000000000111111
    1000000000000000011000000000011111000001   
   1111000111000000110100000000000000100000111
111100011101010111110000200000000000W000000001
10000001 1000101   100000000000000000001111111
11111111 1111111   111111111111111111111111