    R 1000 1000
    NO ./textures/eagle.xpm
SO ./textures/brick.xpm
WE ./textures/chalice.xpm
EA ./textures/wood.xpm
S ./textures/barrel.xpm

C 225,   30, 0   

 F 220, 100, 2     


        1111  1111111111111111111111
        1001  1110000110000000000001
        1011 11001110000002000001111
        1001110000000000000000001
111111111011000001110000000000001
110000000011000001110111111111111
11110111111111011100000010001
1111011111111101110101001000111111111111
111100001101010111000000100000000000000111111
    1000000000000000011000000000000000000001   
   1111000111000000110100000000S000000001111
11110001110101011111011000000000000000000011
10000001 1000101   1000000000001100000000011
11111111 1111111   1111111111111111111111111 