    R 2000 1000

   

 C 252, 0, 0

 F 100, 100, 110    
 

                        NO ./textures/grey.xpm
                            SO ./textures/brick.xpm


WE ./textures/blue.xpm
EA ./textures/wood.xpm
S ./textures/eye.xpm 


        1111  1111111111111111111111  
        11001  1110000110000000000001
        11011 11001110000000000001111
        1001110000000000000000001
111111111011000001110000000000001
110000000011000001110111111111111
11110111111111011100000010001
1111011111111101110101001000111111111111
111100001101010111000000100000000000000111111
    1000000000000000011000000000011111000001   
   11110001110000001101000000000000001000001
11110001110101011111000000000000000000000001
10000001 1000101   10000000000000W0000011111
11111111 1111111   111111111111111111111111