       R 1000 1000
 

C 225,   30, 0   

 F 220, 100, 1     

  
   
   
1111
110
1111